________________________________________________________________
________________________________________________________________
_______XXXXXXXXXXXXXXXXXXXXXXXXXXXXXXXXXXXXXXXXXXXXXXXXXXX______
_______XXXXXXXXXXXXXXXXXXXXXXXXXXXXXXXXXXXXXXXXXXXXXXXXXXX______
_______XXXXXXXXXXXXXXXXXXXXXXXXXXXXXXXXXXXXXXXXXXXXXXXXXXX______
_______XXXXXXXXXXXXXXXXXXXXXXXXXXXXXXXXXXXXXXXXXXXXXXXXXXX______
___________________________________________0____________________
___________________________________________0____________________
___________________________________________0____________________
___________________________________________0____________________
__________________XXXX__________________XXXXXXXXXXXXXXXXXXXX____
__________________XXXX__________________XXXXXXXXXXXXXXXXXXXX____
__________________XXXX__________________XXXXXXXXXXXXXXXXXXXX____
__________________XXXX000000000000000000XXXXXXXXXXXXXXXXXXXX____
__________________XXXX__________________________________________
__________________XXXX__________________________________________
__________________XXXX__________________________________________
__________________XXXX__________________________________________
__________________XXXX__________________________________________
__________________XXXX__________________________________________
__________________XXXX__________________________________________
__________________XXXX__________________________________________
__________________XXXX__________________________________________
__________________XXXX__________________________________________
__________________XXXX__________________________________________
__________________XXXX__________________________________________
__________________XXXX__________________________________________
________________________________________________________________
________________________________________________________________
________________________________________________________________
________________________________________________________________
________________________________________________________________
